32 22
100 45
0 0 0 0 0 0 0 0 0 0 0 0 0 0 0 0 0 0 0 0 0 0 0 0 0 0 0 0 0 0 0 0
0 0 0 0 0 0 0 0 0 0 0 0 0 0 0 0 0 0 0 0 0 0 0 0 0 0 0 0 0 0 0 0
0 0 5 5 5 5 5 5 7 8 8 8 3 9 4 8 8 8 8 8 8 8 8 8 6 5 5 5 5 5 0 0
0 0 5 5 5 5 5 5 7 8 8 8 6 5 7 8 8 8 8 8 8 8 8 8 6 5 5 5 5 5 0 0
0 0 5 5 5 5 5 5 7 8 8 8 6 5 7 8 8 8 8 8 8 8 8 8 6 5 5 5 5 5 0 0
0 0 5 5 5 5 5 7 8 8 8 8 6 5 7 8 8 8 8 8 8 8 8 8 8 6 5 5 5 5 0 0
0 0 5 5 5 5 5 7 8 8 8 8 6 5 7 8 8 8 8 8 8 8 8 8 8 6 5 5 5 5 0 0
0 0 5 5 5 7 8 8 8 8 8 8 6 5 7 8 8 8 8 8 8 8 8 8 8 8 6 5 5 5 0 0
0 0 5 5 7 8 8 8 8 8 8 8 6 5 7 8 8 8 8 8 8 8 8 8 8 8 8 6 5 5 0 0
0 0 5 7 8 8 8 8 8 8 8 8 6 5 7 8 8 8 8 8 8 8 8 8 8 8 8 8 6 5 0 0
0 0 8 8 8 8 8 8 8 8 8 8 6 5 7 8 8 8 8 8 8 8 8 8 8 8 8 8 8 8 0 0
0 0 8 8 8 8 8 8 8 8 8 8 6 5 7 8 8 8 8 8 8 8 8 8 8 8 8 8 8 8 0 0
0 0 8 8 8 8 8 8 8 8 8 8 6 5 7 8 8 8 8 8 8 8 8 8 8 8 8 8 8 8 0 0
0 0 8 8 8 8 8 8 8 8 8 8 6 5 7 8 8 8 8 8 8 8 8 8 8 8 8 8 8 8 0 0
0 0 8 8 8 8 8 8 8 8 8 8 6 5 7 8 8 8 8 8 8 8 8 8 8 8 8 8 8 8 0 0
0 0 8 8 8 8 8 8 8 8 8 8 6 5 7 8 8 8 8 8 8 8 8 8 8 8 8 8 8 8 0 0
0 0 8 8 8 8 8 8 8 8 8 8 6 5 7 8 8 8 8 8 8 8 8 8 8 8 8 8 8 8 0 0
0 0 8 8 8 8 8 8 8 8 8 8 6 5 7 8 8 8 8 8 8 8 8 8 8 8 8 8 8 8 0 0
0 0 8 8 8 8 8 8 8 8 8 8 6 5 7 8 8 8 8 8 8 8 8 8 8 8 8 8 8 8 0 0
0 0 8 8 8 8 8 8 8 8 8 8 1 10 2 8 8 8 8 8 8 8 8 8 8 8 8 8 8 8 0 0
0 0 0 0 0 0 0 0 0 0 0 0 0 0 0 0 0 0 0 0 0 0 0 0 0 0 0 0 0 0 0 0
0 0 0 0 0 0 0 0 0 0 0 0 0 0 0 0 0 0 0 0 0 0 0 0 0 0 0 0 0 0 0 0

