32 22
10 5
0 0 0 0 0 0 0 0 0 0 0 0 0 0 0 0 0 0 0 0 0 0 0 0 0 0 0 0 0 0 0 0
0 0 0 0 0 0 0 0 0 0 0 0 0 0 0 0 0 0 0 0 0 0 0 0 0 0 0 0 0 0 0 0
0 0 8 8 8 8 8 8 8 5 5 5 6 5 7 8 8 8 8 8 8 8 8 8 8 8 8 8 8 8 0 0
0 0 8 8 8 8 8 8 5 5 5 5 6 5 7 8 8 8 8 8 5 5 5 5 5 8 8 8 8 8 0 0
0 0 8 8 8 8 8 8 5 5 5 5 6 5 7 8 8 8 8 8 5 5 5 5 5 5 5 8 8 8 0 0
0 0 8 8 8 8 8 8 8 5 5 5 6 5 7 8 8 8 8 5 5 5 5 5 5 5 5 8 8 8 0 0
0 0 8 8 8 5 5 5 5 5 0 0 0 6 7 0 0 5 5 5 5 5 5 5 5 5 5 5 5 5 0 0
0 0 8 8 8 8 8 8 8 5 0 0 0 6 7 0 0 0 5 5 5 5 5 5 5 5 8 8 8 8 0 0
0 0 8 8 8 8 8 8 8 0 0 0 0 6 7 0 0 0 0 1 5 5 5 5 8 8 8 8 8 8 0 0
0 0 8 8 8 8 8 8 0 0 0 0 1 6 7 1 0 0 0 0 8 8 8 8 8 8 8 8 8 8 0 0
0 0 8 8 8 8 8 8 8 8 8 1 1 6 7 1 1 8 8 8 8 8 8 8 8 8 8 8 8 8 0 0
0 0 8 8 8 8 8 8 8 8 8 1 1 6 7 1 1 8 8 8 8 8 8 8 8 8 8 8 8 8 0 0
0 0 8 8 8 8 8 8 0 0 0 0 1 6 7 1 0 0 0 0 8 8 8 8 8 8 8 8 8 8 0 0
0 0 8 8 5 5 8 8 8 0 0 0 0 6 7 0 0 0 0 1 1 8 8 8 8 8 8 8 8 8 0 0
0 0 8 8 5 5 5 5 5 5 0 0 0 6 7 0 0 0 8 8 8 8 8 8 8 8 8 8 8 8 0 0
0 0 8 8 5 5 8 5 5 1 1 0 6 5 7 1 1 1 8 8 8 8 8 8 8 8 8 8 8 8 0 0
0 0 8 8 5 5 5 5 1 1 1 1 6 5 7 7 1 8 8 8 8 8 8 8 8 8 8 8 8 8 0 0
0 0 8 8 5 5 5 5 1 1 5 5 6 5 7 5 5 5 5 5 8 8 8 8 8 8 8 8 8 8 0 0
0 0 8 8 5 5 5 5 1 5 5 5 6 5 7 5 5 5 5 5 5 8 8 8 8 8 8 8 8 8 0 0
0 0 8 8 5 5 5 5 5 5 5 5 6 5 7 5 5 5 5 5 5 5 8 8 8 8 8 8 8 8 0 0
0 0 0 0 0 0 0 0 0 0 0 0 0 0 0 0 0 0 0 0 0 0 0 0 0 0 0 0 0 0 0 0
0 0 0 0 0 0 0 0 0 0 0 0 0 0 0 0 0 0 0 0 0 0 0 0 0 0 0 0 0 0 0 0

